room5
- - - W W W W W W W F W - - - E
- - - W T F M F T W F W - - - E
- - - W F F F F F W F W W W W E
- - - W F F F F F W F F F F F E
W W W W X X X X X C W W W W W E
F F F F F F F F F F F F F F F E
W W W W X X X X X X X W W W W E
- - - D F F F F F F F W - - - E
- - - W T F F M F F T W - - - E
- - - W W W W W W D W W - - - E
- - - - - - - - - - - - - - - E
- - - - - - - - - - - - - - - E
- - - - - - - - - - - - - - - E
- - - - - - - - - - - - - - - E
- - - - - - - - - - - - - - - E